Preparate Carne Porc
Denumire produs	Unitate de măsură	Alertă stoc (kg)
Cârnați proaspeți de porc	Kg	4
Cârnați afumați de porc	Kg	3
Cârnați subțiri de porc	Kg	3
Cârnați cabanos de porc	Kg	2
Salam crud-uscat de porc	Kg	2
Salam fiert-afumat de porc	Kg	2
Șuncă presată de porc	Kg	2
Șuncă fiartă de porc	Kg	3
Șuncă afumată de porc	Kg	2
Șuncă crud-uscată (prosciutto) de porc	Kg	2
Kaiser (piept afumat) de porc	Kg	2
Bacon feliat de porc	Kg	3
Bacon cuburi de porc	Kg	2
Pancetta maturată de porc	Kg	2
Mușchi file afumat de porc	Kg	2
Mușchi țigănesc de porc	Kg	2
Cotlet afumat de porc	Kg	2
Ciolan afumat de porc	Kg	2
Costiță afumată de porc	Kg	2
Slănină afumată de porc	Kg	2
Jumări de porc	Kg	2
Șorici pufuleți de porc	Kg	1
Șorici fiert (ambalat) de porc	Kg	1
Tobă de porc	Kg	1
Caltaboș de porc	Kg	1
Sângerete de porc	Kg	1
Leber de porc	Kg	1
Pate de ficat de porc	Kg	2
Parizer de porc	Kg	2
Crenvurști de porc	Kg	2
Virșli de porc	Kg	1
Chiftele de porc (semi-preparat)	Kg	2
Mini-chiftele de porc (semi-preparat)	Kg	2
Mici de porc	Kg	3
Burger de porc (semi-preparat)	Kg	2
Cârnați de grătar condimentați de porc	Kg	3
Ruladă de porc (semi-preparat)	Kg	2
Ceafă marinată de porc	Kg	3
Friptură marinată de porc	Kg	3

Pește proaspăt
Denumire produs	Unitate de măsură	Alertă stoc (kg)
Pește proaspăt – somon file	Kg	3
Pește proaspăt – ton steak	Kg	2
Pește proaspăt – cod file	Kg	2
Pește proaspăt – doradă eviscerată	Kg	4
Pește proaspăt – biban de mare	Kg	3
Pește proaspăt – păstrăv întreg	Kg	4
Pește proaspăt – șalău	Kg	2
Pește proaspăt – crap	Kg	2
Pește proaspăt – calcan	Kg	1
Pește proaspăt – macrou	Kg	2

Pește congelat
Denumire produs	Unitate de măsură	Alertă stoc (kg)
Pește congelat – somon file	Kg	4
Pește congelat – cod file	Kg	4
Pește congelat – merluciu (hake) file	Kg	4
Pește congelat – pollock file	Kg	3
Pește congelat – pangasius file	Kg	3
Pește congelat – păstrăv file	Kg	2
Pește congelat – ton cuburi	Kg	2
Pește congelat – mix file pește	Kg	3

Fructe de mare
Denumire produs	Unitate de măsură	Alertă stoc (kg)
Fructe de mare congelate – creveți decorticați	Kg	4
Fructe de mare congelate – creveți cu coajă	Kg	3
Fructe de mare congelate – midii în cochilie	Kg	3
Fructe de mare congelate – midii miez	Kg	2
Fructe de mare congelate – scoici vongole	Kg	2
Fructe de mare congelate – calamar inele	Kg	3
Fructe de mare congelate – calamar tub	Kg	2
Fructe de mare congelate – sepie	Kg	1
Fructe de mare congelate – caracatiță	Kg	1
Fructe de mare congelate – mix fructe de mare	Kg	4

Mezeluri (din pește)
Denumire produs	Unitate de măsură	Alertă stoc (kg)
Pește (produs) – surimi bastoane	Kg	2
Pește (produs) – icre (materie primă)	Kg	1
Pește (produs) – salată de icre	Kg	1

Produse afumate (din pește)
Denumire produs	Unitate de măsură	Alertă stoc (kg)
Pește afumat – somon feliat	Kg	2
Pește afumat – păstrăv	Kg	1
Pește afumat – macrou	Kg	2
Pește afumat – hering	Kg	1

Lactate & Ouă
Lapte
Denumire produs	Unitate de măsură	Alertă stoc (kg)
Lapte – integral 3.5%	Kg	5
Lapte – semi-degresat 1.5%	Kg	3
Lapte – fără lactoză	Kg	2

Smântână
Denumire produs	Unitate de măsură	Alertă stoc (kg)
Smântână – fermentată 12%	Kg	3
Smântână – fermentată 20%	Kg	4
Smântână – pentru gătit 30%	Kg	3

Unt
Denumire produs	Unitate de măsură	Alertă stoc (kg)
Unt – 82% grăsime	Kg	3
Unt – clarifiat (ghee)	Kg	1

Brânzeturi maturate
Denumire produs	Unitate de măsură	Alertă stoc (kg)
Brânzeturi maturate – parmezan	Kg	2
Brânzeturi maturate – pecorino	Kg	1
Brânzeturi maturate – grana padano	Kg	2
Brânzeturi maturate – gouda maturată	Kg	2

Brânzeturi proaspete
Denumire produs	Unitate de măsură	Alertă stoc (kg)
Brânzeturi proaspete – telemea	Kg	3
Brânzeturi proaspete – brânză de vaci	Kg	3
Brânzeturi proaspete – ricotta	Kg	2
Brânzeturi proaspete – mascarpone	Kg	2
Brânzeturi proaspete – cremă de brânză	Kg	2

Cașcaval
Denumire produs	Unitate de măsură	Alertă stoc (kg)
Cașcaval – clasic	Kg	4
Cașcaval – afumat	Kg	2

Iaurt
Denumire produs	Unitate de măsură	Alertă stoc (kg)
Iaurt – natural	Kg	3
Iaurt – grecesc	Kg	2

Frișcă
Denumire produs	Unitate de măsură	Alertă stoc (kg)
Frișcă – lichidă 30–35%	Kg	2
Frișcă – spray (produs)	Kg	1

Ouă
Denumire produs	Unitate de măsură	Alertă stoc (kg)
Ouă – proaspete (categoria M/L)	Kg	5
Ouă – albuș pasteurizat	Kg	2

Fructe
Fructe proaspete
Denumire produs	Unitate de măsură	Alertă stoc (kg)
Fructe proaspete – mere	Kg	5
Fructe proaspete – banane	Kg	5
Fructe proaspete – pere	Kg	3

Fructe congelate
Denumire produs	Unitate de măsură	Alertă stoc (kg)
Fructe congelate – căpșuni	Kg	3
Fructe congelate – mango cuburi	Kg	2
Fructe congelate – mix fructe	Kg	3

Fructe uscate
Denumire produs	Unitate de măsură	Alertă stoc (kg)
Fructe uscate – stafide	Kg	2
Fructe uscate – caise	Kg	1
Fructe uscate – prune	Kg	1

Citrice
Denumire produs	Unitate de măsură	Alertă stoc (kg)
Citrice – lămâi	Kg	3
Citrice – portocale	Kg	4
Citrice – grepfrut	Kg	2

Fructe de pădure
Denumire produs	Unitate de măsură	Alertă stoc (kg)
Fructe de pădure – zmeură	Kg	2
Fructe de pădure – afine	Kg	2
Fructe de pădure – mure	Kg	1

Cereale & Panificație
Făină
Denumire produs	Unitate de măsură	Alertă stoc (kg)
Făină – albă tip 000	Kg	5
Făină – albă tip 650	Kg	5
Făină – integrală	Kg	3

Mălai
Denumire produs	Unitate de măsură	Alertă stoc (kg)
Mălai – extra	Kg	3

Orez
Denumire produs	Unitate de măsură	Alertă stoc (kg)
Orez – basmati	Kg	3
Orez – arborio	Kg	2
Orez – cu bob rotund	Kg	2

Paste
Denumire produs	Unitate de măsură	Alertă stoc (kg)
Paste – spaghetti	Kg	3
Paste – penne	Kg	3
Paste – tagliatelle	Kg	2

Pâine
Denumire produs	Unitate de măsură	Alertă stoc (kg)
Pâine – albă feliată	Kg	3
Pâine – rustică	Kg	3
Pâine – baghetă	Kg	2

Pesmet
Denumire produs	Unitate de măsură	Alertă stoc (kg)
Pesmet – clasic	Kg	2
Pesmet – panko	Kg	2

Aluat
Denumire produs	Unitate de măsură	Alertă stoc (kg)
Aluat – foietaj	Kg	3
Aluat – pizza	Kg	3

Produse de patiserie
Denumire produs	Unitate de măsură	Alertă stoc (kg)
Produse de patiserie – croissant (congelat/ready)	Kg	2
Produse de patiserie – foietaj sărat (ready)	Kg	2

Conserve & Produse procesate
Conserve legume
Denumire produs	Unitate de măsură	Alertă stoc (kg)
Conserve legume – roșii cuburi	Kg	4
Conserve legume – porumb boabe	Kg	3
Conserve legume – fasole roșie	Kg	3

Conserve pește
Denumire produs	Unitate de măsură	Alertă stoc (kg)
Conserve pește – ton bucăți	Kg	2
Conserve pește – sardine	Kg	2
Conserve pește – macrou	Kg	2

Sosuri gata preparate
Denumire produs	Unitate de măsură	Alertă stoc (kg)
Sosuri gata preparate – sos bolognese	Kg	2
Sosuri gata preparate – sos curry	Kg	1
Sosuri gata preparate – sos sweet chili	Kg	1

Murături
Denumire produs	Unitate de măsură	Alertă stoc (kg)
Murături – castraveți murați	Kg	3
Murături – gogonele murate	Kg	2
Murături – varză murată	Kg	4

Semipreparate
Denumire produs	Unitate de măsură	Alertă stoc (kg)
Semipreparate – cartofi prăjiți prefierți	Kg	5
Semipreparate – nuggets (pui)	Kg	3
Semipreparate – șnițel (pui/porc)	Kg	3

Creme și piureuri
Denumire produs	Unitate de măsură	Alertă stoc (kg)
Creme și piureuri – piure de roșii	Kg	4
Creme și piureuri – pastă de ardei	Kg	2
Creme și piureuri – pastă de usturoi	Kg	1

Condimente & Arome
Sare
Denumire produs	Unitate de măsură	Alertă stoc (kg)
Sare – fină	Kg	5
Sare – grunjoasă	Kg	3

Piper
Denumire produs	Unitate de măsură	Alertă stoc (kg)
Piper – negru măcinat	Kg	2
Piper – boabe	Kg	2

Boia
Denumire produs	Unitate de măsură	Alertă stoc (kg)
Boia – dulce	Kg	2
Boia – iute	Kg	1

Ierburi uscate
Denumire produs	Unitate de măsură	Alertă stoc (kg)
Ierburi uscate – oregano	Kg	1
Ierburi uscate – busuioc	Kg	1
Ierburi uscate – cimbru	Kg	1

Mixuri de condimente
Denumire produs	Unitate de măsură	Alertă stoc (kg)
Mixuri de condimente – pentru grătar	Kg	2
Mixuri de condimente – pentru cartofi	Kg	1

Condimente exotice
Denumire produs	Unitate de măsură	Alertă stoc (kg)
Condimente exotice – curry	Kg	1
Condimente exotice – turmeric	Kg	1

Semințe
Denumire produs	Unitate de măsură	Alertă stoc (kg)
Semințe – susan	Kg	1
Semințe – chimen	Kg	1
Semințe – muștar boabe	Kg	1

Uleiuri & Grăsimi
Denumire produs	Unitate de măsură	Alertă stoc (kg)
Ulei vegetal – floarea-soarelui	Kg	5
Ulei vegetal – rapiță	Kg	3
Ulei de măsline – extra virgin	Kg	4
Ulei de măsline – pentru gătit	Kg	3
Untură – porc	Kg	2
Margarina – pentru patiserie	Kg	2
Grăsimi speciale – ulei de susan	Kg	1

Zahăr & Îndulcitori
Denumire produs	Unitate de măsură	Alertă stoc (kg)
Zahăr alb – cristal	Kg	5
Zahăr brun – cristal	Kg	3
Miere – polifloră	Kg	2
Siropuri – arțar	Kg	1
Siropuri – agave	Kg	1
Îndulcitori – stevia	Kg	1

Sosuri & Dressinguri
Denumire produs	Unitate de măsură	Alertă stoc (kg)
Sos tomate – passata	Kg	4
Sos tomate – concentrat	Kg	2
Maioneză – clasică	Kg	3
Maioneză – light	Kg	2
Muștar – clasic	Kg	2
Muștar – Dijon	Kg	1
Ketchup – clasic	Kg	2
Dressinguri – Caesar	Kg	2
Dressinguri – vinaigrette	Kg	1
Creme culinare – cremă de gătit vegetală	Kg	2

Produse congelate
Carne congelată
Denumire produs	Unitate de măsură	Alertă stoc (kg)
Carne congelată – pui (porționat)	Kg	4
Carne congelată – porc (tocătură)	Kg	4
Carne congelată – vită (tocătură)	Kg	3

Legume congelate
Denumire produs	Unitate de măsură	Alertă stoc (kg)
Legume congelate – mix legume	Kg	4
Legume congelate – mazăre	Kg	3
Legume congelate – fasole verde	Kg	3

Produse patiserie congelate
Denumire produs	Unitate de măsură	Alertă stoc (kg)
Produse patiserie congelate – foietaj	Kg	3
Produse patiserie congelate – croissant	Kg	2

Deserturi congelate
Denumire produs	Unitate de măsură	Alertă stoc (kg)
Deserturi congelate – înghețată vanilie	Kg	3
Deserturi congelate – înghețată ciocolată	Kg	3
Deserturi congelate – lava cake (ready)	Kg	2

Nuci, Semințe & Diverse
Denumire produs	Unitate de măsură	Alertă stoc (kg)
Nuci – miez de nucă	Kg	2
Alune – alune de pădure	Kg	2
Semințe – floarea-soarelui	Kg	2
Fructe oleaginoase – migdale	Kg	2
Fructe oleaginoase – caju	Kg	2
Toppinguri – fulgi de cocos	Kg	1
Toppinguri – fulgi de ciocolată	Kg	1

Produse pentru Desert
Denumire produs	Unitate de măsură	Alertă stoc (kg)
Ciocolată – neagră	Kg	3
Ciocolată – lapte	Kg	2
Cacao – pudră	Kg	2
Esențe – vanilie	Kg	1
Esențe – rom	Kg	1
Blaturi – pandișpan (ready)	Kg	2
Creme – cremă de patiserie (bază)	Kg	2
Glazuri – glazură ciocolată	Kg	2

Carne de pasăre — Semipreparate
Denumire produs	Unitate de măsură	Alertă stoc (kg)
Carne de pasăre – pui – nuggets	Kg	4
Carne de pasăre – pui – crispy strips	Kg	4
Carne de pasăre – pui – șnițel (pane)	Kg	4
Carne de pasăre – pui – aripioare marinate BBQ	Kg	4
Carne de pasăre – pui – aripioare picante (hot wings)	Kg	3
Carne de pasăre – pui – frigărui (cuburi marinate)	Kg	3
Carne de pasăre – pui – carne tocată asezonată (chiftele)	Kg	3
Carne de pasăre – pui – burger (chiftea)	Kg	3
Carne de pasăre – pui – kebab/gyros fâșii marinate	Kg	3
Carne de pasăre – curcan – burger (chiftea)	Kg	2
Carne de pasăre – curcan – șnițel (pane)	Kg	2
Carne de pasăre – rață – confit (pulpe)	Kg	1

Mezeluri (carne de pasăre)
Denumire produs	Unitate de măsură	Alertă stoc (kg)
Carne de pasăre – pui – crenvurști	Kg	2
Carne de pasăre – curcan – crenvurști	Kg	2
Carne de pasăre – pui – parizer	Kg	2
Carne de pasăre – curcan – parizer	Kg	2
Carne de pasăre – curcan – salam	Kg	2
Carne de pasăre – pui – pate de ficat	Kg	1
Carne de pasăre – rață – rillettes (pastă)	Kg	1
Carne de pasăre – pui – cârnați proaspeți	Kg	2
Carne de pasăre – curcan – cârnați proaspeți	Kg	2
Carne de pasăre – curcan – șuncă presată	Kg	2

Produse afumate / gata de servit (carne de pasăre)
Denumire produs	Unitate de măsură	Alertă stoc (kg)
Carne de pasăre – pui – piept afumat feliat	Kg	2
Carne de pasăre – curcan – piept afumat feliat	Kg	2
Carne de pasăre – curcan – șuncă afumată	Kg	2
Carne de pasăre – pui – pulpe afumate	Kg	2
Carne de pasăre – rață – piept afumat	Kg	1
Carne de pasăre – rață – pastramă	Kg	1
Carne de pasăre – curcan – pastramă	Kg	2

Carne de vită — Semipreparate / Ready-to-cook
Denumire produs	Unitate de măsură	Alertă stoc (kg)
Carne de vită – burger (chiftea)	Kg	4
Carne de vită – carne tocată asezonată (chiftele)	Kg	3
Carne de vită – mititei (ready)	Kg	3
Carne de vită – kebab/gyros fâșii marinate	Kg	2
Carne de vită – frigărui (cuburi marinate)	Kg	2
Carne de vită – steak porționat (antricot)	Kg	2
Carne de vită – steak porționat (vrăbioară)	Kg	2
Carne de vită – gulas (cuburi)	Kg	2
Carne de vită – pulled beef (gătit, sous-vide/ready)	Kg	1

Mezeluri (carne de vită)
Denumire produs	Unitate de măsură	Alertă stoc (kg)
Carne de vită – salam crud-uscat	Kg	2
Carne de vită – salam fiert-afumat	Kg	2
Carne de vită – pastramă (feliată)	Kg	2
Carne de vită – șuncă presată (feliată)	Kg	1
Carne de vită – parizer	Kg	1
Carne de vită – crenvurști	Kg	1

Produse afumate / gata de servit (carne de vită)
Denumire produs	Unitate de măsură	Alertă stoc (kg)
Carne de vită – pastramă afumată	Kg	2
Carne de vită – mușchi afumat (feliat)	Kg	1
Carne de vită – costiță afumată (beef ribs)	Kg	1

Carne de miel — Semipreparate / Ready-to-cook
Denumire produs	Unitate de măsură	Alertă stoc (kg)
Carne de miel – tocătură asezonată	Kg	2
Carne de miel – chiftele (ready)	Kg	2
Carne de miel – burger (chiftea)	Kg	2
Carne de miel – frigărui (cuburi marinate)	Kg	2
Carne de miel – cotlet porționat (ready)	Kg	2
Carne de miel – pulpă feliată pentru cuptor (ready)	Kg	2
Carne de miel – pastramă (crudă, gata de gătit)	Kg	2
Carne de miel – cârnați proaspeți	Kg	2

Carne de miel — Produse afumate / gata de servit
Denumire produs	Unitate de măsură	Alertă stoc (kg)
Carne de miel – pastramă afumată	Kg	1
Carne de miel – cârnați afumați	Kg	1

Carne de vânat — Semipreparate / Ready-to-cook
Denumire produs	Unitate de măsură	Alertă stoc (kg)
Carne de vânat – mistreț – tocătură	Kg	2
Carne de vânat – mistreț – cârnați proaspeți	Kg	2
Carne de vânat – mistreț – pulpă cuburi (gulaș)	Kg	2
Carne de vânat – cerb – pulpă cuburi (gulaș)	Kg	1
Carne de vânat – cerb – steak porționat	Kg	1
Carne de vânat – căprioară – pulpă cuburi	Kg	1
Carne de vânat – iepure – tranșat (ready)	Kg	1
Carne de vânat – rață sălbatică – tranșată (ready)	Kg	1

Carne de vânat — Mezeluri / produse procesate
Denumire produs	Unitate de măsură	Alertă stoc (kg)
Carne de vânat – salam crud-uscat	Kg	1
Carne de vânat – pastramă (feliată)	Kg	1
Carne de vânat – pate (produs)	Kg	1

Mezeluri mix
Denumire produs	Unitate de măsură	Alertă stoc (kg)
Mezeluri mix – cârnați proaspeți (mix carne)	Kg	4
Mezeluri mix – cârnați afumați (mix carne)	Kg	3
Mezeluri mix – salam crud-uscat (mix carne)	Kg	3
Mezeluri mix – salam fiert-afumat (mix carne)	Kg	3
Mezeluri mix – crenvurști (mix carne)	Kg	3
Mezeluri mix – parizer (mix carne)	Kg	2
Mezeluri mix – șuncă presată (mix carne)	Kg	2
Mezeluri mix – pate (mix carne)	Kg	2

Produse afumate mix
Denumire produs	Unitate de măsură	Alertă stoc (kg)
Produse afumate mix – bacon feliat (mix)	Kg	3
Produse afumate mix – piept afumat (mix)	Kg	2
Produse afumate mix – cotlet afumat (mix)	Kg	2
Produse afumate mix – ciolan afumat (mix)	Kg	2
Produse afumate mix – costiță afumată (mix)	Kg	2
Produse afumate mix – pastramă afumată (mix)	Kg	2
Produse afumate mix – mușchi afumat (mix)	Kg	2
